FLOPINSKI         	 Alue
Bread Incarnate   	 Uprankers
My Angel NathanRam	 NVM
boytots slave ring	 admirateurs2Nos_If
Blue Pants        	 Methylphenidate
sanae san         	 The 4 forensics
rinbot            	 Kehest
Bunny Enjoyers    	 DA ZONE
Red_pixel         	 2hu vape squad
-lion             	 Anton and friends
wooters           	 >c ronaldo7
Baksal            	 bedge
halcyon           	 Seed 63
of 4 is good      	 osu!Team
GuruguruMawaru    	 touhou haters
Fishe             	 JotnyangE fan club
Miku fanclub      	 Dreamy goat
Suwako Moriya     	 ? IQ
ikun              	 GO USA :flag_mx:
10000000 backflips	 4OldManBestSuiGiai
mariSad           	 eniu
MidC              	 Banana da Madeiraüçå
the avengers      	 PengFrogTedotter
good meowning     	 origin_
Reginald          	 MeOwz
chocked up        	 The Tuohuo
grease monkey     	 UOOGGGHHHH MARISAA
ShrineMaidenSlaya 	 Finger Controln't
FishOnFire        	 Rin Kokonoe
bolas peludas     	 HikkaSka
:ruotsi:          	 La+ Ratio
UPRPRC            	 A5 Ramen
